NO ./resource/xpm/wall.xpm
SO ./resource/xpm/wall.xpm
WE ./resource/xpm/wall.xpm
EA ./resource/xpm/wall.xpm

C 160,198,242
F 86,69,87

111111
100111
1001W1
100111
111111
