NO ./resource/xpm/blue.xpm
SO ./resource/xpm/red.xpm
WE ./resource/xpm/green.xpm
EA ./resource/xpm/yellow.xpm

C 160,198,242
F 86,69,87

111111111111
110000101111
110001100111
110000001011
111000000101
110000000111
110001N01111
110000001111
111111111111
111111111111
