NO ./resource/xpm/wall.xpm
SO ./resource/xpm/wall.xpm
WE ./resource/xpm/wall.xpm
EA ./resource/xpm/wall.xpm

C 160,198,242
F 86,69,87

1111111
1100011
100E001
1100011
1111111
