NO ./resource/xpm/blue.xpm
SO ./resource/xpm/red.xpm
WE ./resource/xpm/green.xpm
EA ./resource/xpm/yellow.xpm

C 160,198,242
F 86,69,87

 111111111
10000000001
10001N00001
10000000001
 111111111
