NO ./resource/xpm/blue.xpm
SO ./resource/xpm/red.xpm
WE ./resource/xpm/green.xpm
EA ./resource/xpm/yellow.xpm

C 160,198,242
F 86,69,87

111111111
1000001011
10000110011
100000001011
100000001011
10000000011
100000N111
11111111
