NO ./resource/xpm/blue.xpm
SO ./resource/xpm/red.xpm
WE ./resource/xpm/green.xpm
EA ./resource/xpm/yellow.xpm

C 160,198,242
F 86,69,87

1111111
1110101
1000111
100N101
1111111
