NO ./resource/xpm/blue.xpm
SO ./resource/xpm/green.xpm
WE ./resource/xpm/red.xpm
EA ./resource/xpm/yellow.xpm

C 160,198,242
F 86,69,87

1111
10001
100E1
10011
1111
