NO ./resource/xpm/wall.xpm
SO ./resource/xpm/wall.xpm
WE ./resource/xpm/wall.xpm
EA ./resource/xpm/wall.xpm

C 160,198,242
F 86,69,87

    1111111111111111111111111
  1111000000000110000000000001
  10000000001110000000000001
   11001000000000000000000001111111111111111111111111111
11111111101100000111000000000000000000000000000000000001
10000000001100000111011111111111111111111111111111111101
11110111111111011100000010001                        101
11110111111111011101010010001                        101
11000000110101011100000010001                        101
10000000000000001100000000001                        101
10000000000000000001010010001111111111111111111111111101
11000001110101011111011110N00000000000000000000000000001
11110111 1110101 101111010001111111111111111111111111111
11111111 1111111 111111111111
