NO ./resource/xpm/N.xpm
SO ./resource/xpm/S.xpm
WE ./resource/xpm/W.xpm
EA ./resource/xpm/E.xpm

C 160,198,242
F 86,69,87

11111111111111
11111111111111
11000000000011
11000011000011
11000011000011
11000000000011
110000N0000011
11111111111111
11111111111111
